#######.##
#        #
#   # ## #
# #   #  #
# ### ####
#         #
##### ##  #
#         #
#   ##### #
          #