#######.##
#        .
### # ## #
#     #  #
#  #### ##
#     #  #
#######  #
#        #
#  ##### #
         #