; EASY 1

######.#.#
#        .
#    ### #
#        #
#    ### #
#    #   #
##  ## ###
#        #
#   ## ###
  ########
; NORMAL 1

#######.##
#        .
### # ## #
#     #  #
#  #### ##
#     #  #
#######  #
#        #
#  ##### #
         #
; HARD 1

#######.##
#        #
#   # ## #
# #   #  #
# ### ####
#         #
##### ##  #
#         #
#   ##### #
          #