; EASY 1

######.#.#
#        .
#    ### #
#        #
#    ### #
#    #   #
##  ## ###
#        #
#   ## ###
  ########