-1 ,-1 ,-1 ,-1 ,1  ,2  ,-1 ,-1 ,-1 ,-1 ,-1 ,-1 ,-1 ,-1 ,-1 ,-1
-1 ,-1 ,-1 ,-1 ,10 ,11 ,-1 ,-1 ,-1 ,-1 ,-1 ,-1 ,1  ,2  ,-1 ,-1
1  ,2  ,-1 ,-1 ,-1 ,-1 ,-1 ,-1 ,-1 ,1  ,2  ,-1 ,10 ,11 ,-1 ,-1
10 ,11 ,-1 ,-1 ,1  ,2  ,-1 ,-1 ,-1 ,10 ,11 ,-1 ,-1 ,-1 ,-1 ,-1
-1 ,-1 ,-1 ,-1 ,10 ,11 ,-1 ,-1 ,-1 ,-1 ,-1 ,-1 ,-1 ,-1 ,1  ,2
-1 ,-1 ,-1 ,-1 ,-1 ,-1 ,-1 ,-1 ,-1 ,1  ,2  ,-1 ,-1 ,-1 ,10 ,11
-1 ,-1 ,-1 ,-1 ,1  ,2  ,-1 ,-1 ,-1 ,10 ,11 ,-1 ,-1 ,-1 ,-1 ,-1
-1 ,-1 ,-1 ,-1 ,10 ,11 ,-1 ,-1 ,-1 ,-1 ,-1 ,-1 ,1  ,2  ,-1 ,-1
-1 ,-1 ,-1 ,-1 ,-1 ,-1 ,-1 ,-1 ,-1 ,1  ,2  ,-1 ,10 ,11 ,-1 ,-1
-1 ,-1 ,-1 ,-1 ,1  ,2  ,-1 ,-1 ,-1 ,10 ,11 ,-1 ,-1 ,-1 ,-1 ,-1
-1 ,-1 ,-1 ,-1 ,10 ,11 ,-1 ,-1 ,-1 ,-1 ,-1 ,-1 ,-1 ,-1 ,-1 ,-1
-1 ,-1 ,-1 ,-1 ,-1 ,-1 ,-1 ,-1 ,-1 ,-1 ,-1 ,-1 ,-1 ,-1 ,-1 ,-1
